Replaces the music of vanilla and Fargo's Souls bosses, events and biomes. 
Can be used without Fargo's Souls for only the vanilla tracks.

Thank you Javyz and Terry and MASSIVE thanks to the bfdi wiki

Songs included:
Town (Day): corru.observer - Let Me Out
Town (Night): corru.observer - Remembrance
Overworld (Day): OMORI - A Home For Flowers (Tulip)
Overworld (Night): Homestuck - Doctor
Windy Day: TS!Underswap - Calming Beats to Reflect and Relax To
Underground: Void Stranger - Void Symphony
Desert: Void Stranger - Rage Rave
Snow / Ice: Homestuck - Moonsetter
Jungle: Homestuck - Crystalanthemums
The Hallow: OMORI - Three Bar Logos
Underground Hallow: OMORI - White Surf Style 6
Corruption: corru.observer - Safe Surface
Underground Corruption: corru.observer - Dull Vessel
Crimson: corru.observer - Outside Interference
Underground Crimson: corru.observer - Inner World
Ocean (Day): TS!Underswap - Seaside Beats to Tan and Relax To
Ocean (Night): corru.observer - Their Waters
Space: corru.observer - Breaking Free
Hell: OFF - Avatar Beat
Mushroom Biome: Homestuck - Arisen Anew
Dungeon: OFF - Unreasonable Behavior
Temple: Void Stranger - Getting To Your Manager
Rain: Void Stranger - Gray nostalgia
Thunderstorm: Void Stranger - Void Stranger Gray
Graveyard: Limbus Company - Wuthering Opus 1 (Alternate Version) [Norrian’s suggestion]
Blood Moon: OFF - Pepper Steak
Sandstorm: SM64 - Lethal Lava Land
Aether: Void Stranger - Agents of Void
Goblin Invasion: Homestuck - Skaian Skirmish
Slime Rain: Void Stranger - Bee like that
Pirate Invasion: Homestuck - Pumpkin Party in Sea Hitler’s Water Apocalypse
Eclipse: corru.observer - The Madness Outside
Pumpkin Moon: Battle Cats - Aku Battle Theme
Frost Moon: Deltarune - Gingerbread House
Old One’s Army: Battle Cats - Battle Theme #1
Martian Madness: Battle Cats - Cats of the Cosmos Battle Theme #3
Credits: Void Stranger - Grayish as it may be

Trojan Squirrel: Everhood - Vampires Invading Heaven
King Slime: Void Stranger - Dancion Basement
Eye of Cthulhu: corru.observer - Timestopper Tactics
Cursed Coffin: Void Stranger - Guarantee Void
Eater of Worlds: corru.observer - Endure, Eliminate
Brain of Cthulhu: corru.observer - Hostile Rewrite
Queen Bee: the home depot theme song because i ran out of music
Skeletron: Everhood - The Final Battle
Deerclops: Deltarune - Lost Girl
Devi: Madoka Magica - Connect
Wall of Flesh: corru.observer - RUINOUS INTNT
Dreadnautilus: Fnaf 2 ambience
Queen Slime: OMORI - World’s End Valentine
Banished Baron: ZeroRanger - Sky XXXX Days
Skeletron Prime: corru.observer - Daemons
The Twins: corru.observer - BSTRD
The Destroyer: corru.observer - Impact
Lifelight: OMORI - Tee-hee time
Plantera: Everhood - Feisty Flowers
Golem: Void Stranger - Affront to God
Betsy: Battle Cats - Rush Theme
Duke Fishron: Void Stranger - S** **** ****
Empress of Light: Madoka Magica - Magia
Lunatic Cultist: corru.observer - The Walls Are Trying To Kill Me
Celestial Pillars: corru.observer - Spatial Strategics
Moon Lord: corru.observer - Cast Yourself Aside

Timber Champion: Pitbull - Timber
Terra Champion: Chinese man banging rocks together
Nature Champion: SimpleFlips - Dad 3
Life Champion: Sean Stephens - Rectangular
Shadow Champion: XTRATUNA - THE CIRCLE
Earth Champion: XTRATUNA - AN UNDER’S TALE (chorus only)
Spirit Champion: Keuperz - curse of armored parhoah
Will Champion: The Living Tombstone - It’s Been So Long
Eridanus: Void Stranger - The False Ruler of All Heavens
Abominationn: A Hat in Time - Your Contract Has Expired
Mutant: Void Stranger - Void the Sky
Mutant (alt): Everhood - Revenge